microwave-cloth-approach,microwave-cloth-depart,Head-bowl-approach,Head-bowl-depart,bowl-milk-approach,bowl-milk-depart,LH-book-approach,LH-book-depart,LH-medcinebox-approach,LH-medcinebox-depart,Head-RH-approach,Head-RH-depart,Head-microwave-approach,Head-microwave-depart,LH-cloth-approach,LH-cloth-depart,LH-bowl-approach,LH-bowl-depart,microwave-cup-approach,microwave-cup-depart,LH-microwave-approach,LH-microwave-depart,Head-box-approach,Head-box-depart,bowl-box-approach,bowl-box-depart,RH-medcinebox-approach,RH-medcinebox-depart,microwave-bowl-approach,microwave-bowl-depart,microwave-box-approach,microwave-box-depart,Head-LH-approach,Head-LH-depart,LH-cup-approach,LH-cup-depart,LH-box-approach,LH-box-depart,RH-bowl-approach,RH-bowl-depart,Head-cup-approach,Head-cup-depart,LH-milk-approach,LH-milk-depart,RH-LH-approach,RH-LH-depart,RH-book-approach,RH-book-depart,RH-milk-approach,RH-milk-depart,RH-box-approach,RH-box-depart,RH-cup-approach,RH-cup-depart,RH-cloth-approach,RH-cloth-depart,RH-microwave-approach,RH-microwave-depart
0,0,0,0,0,0,0,0,1,1,2,2,0,0,0,0,0,0,0,0,0,0,0,0,0,0,2,2,0,0,0,0,0,0,1,1,0,0,0,0,1,1,0,0,2,2,0,0,0,0,0,0,3,3,0,0,0,0
0,0,0,0,0,0,0,0,0,0,2,2,0,0,0,0,0,0,0,0,0,0,0,0,0,0,1,1,0,0,0,0,0,0,0,0,0,0,0,0,1,1,0,0,2,2,0,0,0,0,0,0,1,2,0,0,0,0
0,0,0,0,0,0,0,0,0,0,2,2,0,0,0,0,0,0,0,0,0,0,0,0,0,0,3,3,0,0,0,0,0,0,1,1,0,0,0,0,1,1,0,0,2,2,0,0,0,0,0,0,1,2,0,0,0,0
0,0,0,0,0,0,0,0,4,3,0,0,0,0,0,0,0,0,0,0,0,0,0,0,0,0,1,1,0,0,0,0,1,1,1,1,0,0,0,0,1,1,0,0,3,4,0,0,0,0,0,0,2,2,0,0,0,0
0,0,0,0,0,0,0,0,1,2,1,1,0,0,0,0,0,0,0,0,0,0,0,0,0,0,1,1,0,0,0,0,3,3,1,0,0,0,0,0,1,1,0,0,2,1,0,0,0,0,0,0,1,1,0,0,0,0
0,0,0,0,0,0,0,0,1,1,0,0,0,0,0,0,0,0,0,0,0,0,0,0,0,0,2,1,0,0,0,0,2,2,2,2,0,0,0,0,1,1,0,0,2,2,0,0,0,0,0,0,0,0,0,0,0,0
0,0,0,0,0,0,0,0,1,2,1,1,0,0,0,0,0,0,0,0,0,0,0,0,0,0,1,1,0,0,0,0,1,1,0,0,0,0,0,0,1,1,0,0,3,3,0,0,0,0,0,0,1,0,0,0,0,0
0,0,0,0,0,0,0,0,1,1,1,1,0,0,0,0,0,0,0,0,0,0,0,0,0,0,1,1,0,0,0,0,1,1,1,1,0,0,0,0,1,1,0,0,2,2,0,0,0,0,0,0,0,0,0,0,0,0
0,0,0,0,0,0,0,0,1,1,1,1,0,0,0,0,0,0,0,0,0,0,0,0,0,0,2,2,0,0,0,0,1,1,0,0,0,0,0,0,1,1,0,0,1,1,0,0,0,0,0,0,1,1,0,0,0,0
0,0,0,0,0,0,0,0,1,1,1,1,0,0,0,0,0,0,0,0,0,0,0,0,0,0,1,1,0,0,0,0,1,1,0,0,0,0,0,0,1,1,0,0,2,2,0,0,0,0,0,0,2,2,0,0,0,0
0,0,0,0,0,0,0,0,2,2,1,1,0,0,0,0,0,0,0,0,0,0,0,0,0,0,1,1,0,0,0,0,1,1,0,0,0,0,0,0,1,1,0,0,4,4,0,0,0,0,0,0,2,2,0,0,0,0
0,0,0,0,0,0,0,0,3,3,1,1,0,0,0,0,0,0,0,0,0,0,0,0,0,0,1,1,0,0,0,0,1,1,1,1,0,0,0,0,1,1,0,0,2,2,0,0,0,0,0,0,1,2,0,0,0,0
